,,,,,,,,,,,,,,,,,,,,
,,,,,,,,,,,,,,,,,,,,
,,,xxxxxxxxxxxxxx,,,
,,,x............x,,,
,,,x............x,,,
,,,x............x,,,
,,,x............x,,,
,,,x.....1......x,,,
,,,x............x,,,
,,,x............x,,,
,,,x..d.........x,,,
,,,x............x,,,
,,,xxxxxxxxxxxxxx,,,
,,,,,,,,,,,,,,,,,,,,
,,,,,,,,,,,,,,,,,,,,
EOM
1: 10, 40
